NO ./assets/0.xpm
SO ./assets/1.xpm
EA ./assets/2.xpm
WE ./assets/3.xpm

F 130,130,130
C 190,190,255

1111111111
1100110001
1000000101
1000000001
1000000011
1100N00011
1000000011
1000000001
1011110001
1111111111