1111111111
1100000001
1000000101
1000000001
1100000001
1000000001
100S000011
1000000001
1100000011
1111111111