11111111111
11000110001
10000000101
10000000001
10000000011
11000E00011
10000000011
10000000001
10011110001
11111111111