1111111111
1100100001
1000000101
1000000001
1000000001
1100N00011
1000000001
1000000001
1100100011
1111111111