1111111111
1100110001
1000000101
1000000001
1000000011
1100000011
1000E00011
1000000001
1011110001
1111111111