11111111111
11000100001
10000000101
10000000001
10000000001
11000N00011
10000000011
10000000001
11000100011
11111111111
